......#...........#...#........
.#.....#...##.......#.....##...
......#.#....#.................
..............#.#.......#......
.....#.#...##...#.#..#..#..#..#
.......##...#..#...........#...
.......#.##.#...#.#.........#..
..#...##............##......#.#
.......#.......##......##.##.#.
...#...#........#....#........#
#............###.#......#.....#
..#........#....#..#..........#
..#..##....#......#..#......#..
........#......#......#..#..#..
..#...#....#..##.......#.#.....
.....#.#......#..#....#.##.#..#
......###.....#..#..........#..
.#................#.#..........
.........#..#...#......##......
##...#....#...#.#...#.##..#....
...##...#....#.........###.....
.#.#....#.........##...........
....#.#..#..#...........#......
..#..#.#....#....#...#.........
..........##.....#.##..........
..#.#....#..##......#.#.....##.
..#...#.##......#..........#...
......#....#..#.....#.....#...#
#.#...##.#.##.........#..#.....
...#.#.#.........#.....#.#.#...
..#.........#...............#..
#..##.....#.........#....#.....
...#....##..##...........##..#.
......##.................#.#...
##.......#....#.#.#.....#......
....#.#...#.................##.
#...#.........##.....#.........
#....#.###..#.....##.#....#....
#..#....#...#....#.#.#.........
.......#...........#....#.....#
#...#.............#........#...
.......#.....#...#..#.........#
.##.....##.....##.......#......
....##...##.......#..#.#.....#.
.##.........#......#........##.
.......#...#...###.#..#........
..#..###......##..##...........
.#..#......##..#.#.........#...
...#.......#........#...#.#....
...#....#..#....#.....##.......
............#......#..........#
.#.......#......#.#....#..#.#..
##.........#.#.#..........#....
....##.....#...................
.......#..#........#...........
....##.#..#......###.......#...
....#....#...#.#......#...#...#
.......#.....##..#....#...#....
#...#........#.........#..##...
...........##.........#.#...#..
....................#....#.##..
.#..#..#.........#....#..#..##.
......................#........
..###....#.......#.....###.##..
......#......#.......#.....#..#
.....#...#.##...#......#....#..
.....#.....##.............#....
....#......##..#....#.......#..
.##....#..##......###....#..#..
...###.#.............##...#.#..
.....#.....#.....#...#..#.#....
..#.#.....###......#.......#...
..........#.##......#.........#
..##..#.......................#
........#......#............#..
#..#..#..#.#......#..#....#....
...##......#.............#....#
...........#..#..##.......#....
.....#.........#.#..#..........
##...#.......#.#....#..#..#....
#.#.#...........#.##.#.#..###..
#..#...........#.........##....
............#.#..............#.
.#....#....##.#...........#..#.
....#...#..#...#....#....#.....
....#....#...#..#......#.......
.#.#.........#.......#.##......
.#..##...#........#...........#
##...#..#...#...#.....#...#....
....###.#..#.......##.#..#...#.
...##.......####...##.#........
#....#....#.#............#..#..
#.#.#...#...................##.
##......#...........#..........
#..#..#....#.#...#......#......
.##...#.....#...#........#.....
..#............#..............#
###........#..#....#...#......#
###..##......#.##...........#..
........#......#..#.....#......
...#..........#..#...........#.
....#..#..#....#........#....#.
.#.................#####..##..#
.....#...##..#..........#.##...
..#..............#...####......
.....#.##..................#.#.
...#.#..#..#........#..........
...........#....#.#..#.........
.....##.......#......#..#.#.#..
...#.............##...#........
...............#.......##.##.##
.....#........#........#.#..#..
...#..#.........#...##...###...
...#.#.............###.#.....#.
.#..........#......###.#.#.....
....##..##.............###.....
..#..#.#...##...#.......##.....
..........###........#.....#.#.
#.#....#..#..#......#...#...#..
.........#......##.......#.#..#
...#.....#.........##..#..#....
.....##.#..##.##..##...........
...#.#.##....#..#..#......#..#.
#....#....#.............#...##.
#......#..#.####.#.##.#....##..
##.#.#....##..................#
.....##......#.......##.......#
..#......#.#..#...##......##...
..#....##....#.........#..##...
.###.....#....##...........#...
.........#......#.#........#...
...#...#..#.#....######.#..#...
###......#.#.#.........##.#....
.....#...#.........#...#.......
....#.............#.#.........#
..##...#...#.......#......#....
.....#...#.#...#...#..#........
.#......#......................
...###..#..#....#...##.#.......
.#.#.....##...#...#.....#...##.
.....###..###....##............
.....##....#..#.....#.##.......
#........#.........#...#..#....
...#.#.........#..#.......#.#..
....#.#....##.....#..........#.
.#..#....#..#.#..#..#.........#
#...#....#..............#......
.........#.....#.##...##...###.
.....#....##............#..#...
.....#.#...........#..#....#...
.#..........#...#......#.....#.
.#...........#.....#..#........
..............#......##...#..#.
...#.........#..#....#..##...##
..##...#..................#....
#.....#.................#......
...#......#..#..........#.#....
......#..#.....#.....##...#..#.
......#........#..........#....
...##.##....#..##.#..........#.
..........#..#.#.##............
..##........................#..
.....#.#.#......#....#....##...
#....#.........#........#......
.##.......#...#...#........##..
....##......#....#.#..........#
..#.......#..............#.....
.....#......#.#...#..#.#.#....#
.....#..#........#.##.##.......
##........#..........#.........
.....#..##....#.#......###..##.
#.#...##.........#.#.....#..#..
#....#.#...#........#.....#..#.
........................#......
....###......#............#...#
...#..##......#..##.........#..
.............#...#......#..#..#
....#......#....#...........#..
..#.#.####.#.....##........#..#
#..#...#..#..#.......#.#..#....
..#..#..#....#.#.........##..#.
.......#......#.#............#.
...#.............#.#.....#.....
...#.#.........##...#.#.......#
........#...#...........##...#.
..........#....#......#....##..
..........#...........#........
...#..#...#..........#......#..
......#......#....#.....#..#.#.
........##.................#..#
.#........#.#...........#......
#...#........#.#.#.....#.#.#...
.........#........#..#..#....#.
##........#..........#....#..#.
.#.##...........#..#.#..##....#
.......#.#....#..#......#......
..#.....#........##..#......###
..#...#..................#....#
......#...#..#.##.......#......
........#...#.#................
.........#............#........
..#.....##....#.#..##..........
#.....#..........#....#........
....#.#...#...##....#.....##...
..#.#.......#.............#...#
...##..............#......#....
#......#...#................##.
.#.#...#.#..#..................
...##.......#...........#.#.#..
#......#.#.#........#.##...####
.......#..#.#.........#.#.##..#
..............#....#.........#.
...........#.#..#....##......#.
#.............#...##..#.......#
.........#............#...#.##.
.......#.........#.#.....#..#..
........................#.#.##.
#......#.#......#.........#....
...#.......#.......#.....#.....
#..#....#................#...#.
........#.#..##......#.........
#..#...##....##....##.........#
.......#...#...###.............
#.#..#........#.#.#............
#.....#........##.........#.#..
.#..........#....#.#....###....
.#.....#...#.#........#..#.##..
...#.##......#..#.............#
..##..#.#...................#..
.....#....#...#.#...#...#......
.....#..#.#....#.#.............
#.#....#.#.##..###..........#..
........#.#.............#..#...
.........#.......#.............
.##.#............##...#........
......#................#.......
...............#..#...........#
...#.......#...#.##.....#....#.
##..##..#..........#...........
.##.#.......#...#..#...#...#...
....#..#...........#....#.##...
.#........#........#....#......
.......#...#.##.#..#.#..#......
.#..#......#....#...##....#.#..
......#...##.#.....##.###.....#
.#....#..#......#...#.#.....#..
#............#....##...##.##...
#...#.#....#...#.......##...##.
#...........#.##..#....#.....#.
...#..#...#.........#.......#..
.#....#.....#............#.#..#
.#.....#.#...#.#....##......###
..#..#.#.#...#..#.............#
...#...#..#....#........#...##.
.......#.....#...##...........#
#.##.................#...##...#
..............##........#.....#
............#...#..#.......#.#.
#.#.....#.........#...#......#.
#.###..#......#..#..#...#.....#
.....#.......#.................
........#..#......#.#...#......
#.......#..#........#...#..#...
..#...#.......##.............#.
#.......#.......##...#.........
.........#....#.#..##.....#...#
..#.....#.#.......#....#.......
...#.......#.....#..##.#..#....
....#.......#.#.#..............
.#..#......#........#.#..##..##
....#...#.##.#...#....##...#...
#..##..#.....#.......#.........
....#..#..#.#............#.....
#.......##...##..##............
...............................
....#.......#.##...#.....#.#...
...#........#....#.#..#..#.....
##.......#.....##.#.#....#....#
#.............#...........#.##.
#...........#.#..........#.....
#..#....#....#.#.........#.#...
......#.#.#..#.#.#.............
...#.....#........##....#......
..#...#...#.#.......#......#...
.##........#...#..#..........#.
..#...........#..##.....##.....
............#..#.#...#.....#...
..........#....##.......#......
....#....#.................#..#
....#...............#.........#
..#.#...#......#..........##...
.....#...........#.........#..#
.......#.....##.....#.#........
.#.#..........#....#...........
.#..##....#........#....#......
....#.#..#.......#..#.........#
..#....#.....#......#..#.......
......#........#.......#...#.#.
.......#.......#....#.....##...
....##........#..#...#.#..#...#
.#......#...........##....#....
##....##......#.......#.......#
.##....#.##......#.......##..#.
...#..#.#.#.......#..#.###.....
..........##....#..#.##........
...#........###.#..#........#..
.....#....#..##....#.....#....#
#..........#..........#.#....#.
..#....#.....#..............#..
#..................#......#.##.
.#...#.#.....#.........##......
...#...........#.....#......#..
......#.....#.#..##......##....
...#....###..#.....#..#..##..##
......#.......##..#..#.........
#..#.#....#.#..#..........##.#.
..#..#..##..#.#.#.#.....#......
..#.#...#..#.....###.#.........
##.#.#......#........#.####....
.............#..#..#....#......
...##..........#.......#.#....#
..#.....................#......
